1 1 1 4 1 1
1 4 1 4 0 0
1 4 3 4 3 3
2 3 5 4 5 2
3 3 1 5 0 0
