2 0 2 0 2 0 2
3 3 3 3 3 3 3
2 2 0 2 0 2 2
1 0 1 0 1 0 1
0 2 0 2 0 2 0
