0 4 3 3 1 3 0
1 0 3 2 2 2 1
4 3 5 0 1 1 3
1 0 2 4 1 4 4
5 0 2 5 1 3 3
