1 2 5 4 4
0 4 4 5 4
0 2 3 2 0
1 0 2 5 5
2 1 1 3 4
