4 2 0 5 3 3 1
0 4 4 5 3 4 5
3 3 3 4 3 2 0
4 5 5 4 2 5 3
5 2 2 2 5 5 0
